0000000000
0000000000
-------200	
0000000+00
0000000+00
-----20+00
00000+0+00
000004-300
0000000000
0000000000
